##############
#............#
#####G  G#####
#####H  P#####
#. ........ .#
#. ........ .#
#. ..####.. .#
#. ..####.. .#
#. ..####.. .#
#. ........ .#
######G  G####
######H  P####
#  ........  #
#S ........  #
###############